R 720 480

EA   ./texture/brown-brick-wall-texture.xpm

NO ./texture/old-brick-texture.xpm

WE  ./texture/yellow-wall-texture.xpm

SO   ./texture/red-brick-wall-texture.xpm



S   ./texture/sprite.xpm


C    123,104,238

F     105,105,105


1111111111
1000000001
1111000001
1000000001
100W000001
1000001001
1000001001
1111111111