R  1111 200

EA   ./texture/bluestone.xpm

NO ./texture/eagle.xpm



WE  ./texture/mossy.xpm
SO   ./texture/colorstone.xpm



S   ./texture/monstre.xpm


C     220,100,0 

F     0, 250, 0 


1111111111111
1010101101011
1010101101011
10000N0000001
1000000000001
1111111111111