R  1111 200

EA   ./texture/bluestone.xpm

NO ./texture/eagle.xpm



WE  ./texture/mossy.xpm
SO   ./texture/colorstone.xpm



S   ./texture/monstre.xpm

C     220,100,0 

F     0, 250, 0 




        1111111111111111111111111
        1000000000110000000000001
        1011000001110000002000001
        1001000000000000000000001
111111111011000001110000000000001
100000000011000001110111111111111
11110111111111011100000010001
111101111111110111110100100011
11000000110S01011 100000010001
10002000000000001 100000010001
10000000000000001 100101010001
1100000111010101111101111010111
11110111 1110101 101111010001
11111111 1111111 111111111111