R  1111 200

EA   ./texture/bluestone.xpm

NO ./texture/eagle.xpm



WE  ./texture/mossy.xpm
SO   ./texture/colorstone.xpm



S   ./texture/monstre.xpm

C     255,0,  0 

F     0,255,25 




        1111111111111111111111111
        1000000000110000000000001
        1011000001110000002000001
        1001000000000000000000001
111111111011000001110000000000001
100000000011000001110111111111111
11110111111111011100000010001
11110111111111011101010010001
11000000110101011111111111001
1000200000000001         1101
10000000000000011111111111001
11000001110101011111011110N0111
11110111 1110101 101111010001
11111111 1111111 1111111111111111111