R 720 480

EA   ./texture/east-texture.xpm

NO ./texture/north-texture.xpm
WE  ./texture/west-texture.xpm
SO   ./texture/south-texture.xpm

S   ./texture/sprite.xpm




C    123,104,238

F    105,105,105


1111111111
1000000001
1111000001
1002000001
100N020001
1000001001
1002001001
1111111111